abandon (v): từ bỏ
ability (n): khả năng
access (n): truy cập
acquire (v): đạt được
adapt (v): thích nghi
adjust (v): điều chỉnh
advantage (n): lợi thế
agriculture (n): nông nghiệp
alternative (n): thay thế
analyse (v): phân tích
approach (n): phương pháp tiếp cận
appropriate (adj): phù hợp
assess (v): đánh giá
assume (v): giả định
available (adj): có sẵn
benefit (n): lợi ích
challenge (n): thử thách
community (n): cộng đồng
compensate (v): bồi thường
component (n): thành phần
conclude (v): kết luận
conduct (v): tiến hành
consequence (n): hậu quả
considerable (adj): đáng kể
constant (adj): không thay đổi
consume (v): tiêu thụ
contribute (v): đóng góp
create (v): tạo ra
culture (n): văn hóa
decline (v): suy giảm
design (v): thiết kế
distinct (adj): khác biệt
environment (n): môi trường
evaluate (v): đánh giá
evidence (n): bằng chứng
expand (v): mở rộng
feature (n): đặc điểm
function (n): chức năng
generate (v): tạo ra
impact (n): tác động
individual (n): cá nhân
influence (v): ảnh hưởng
maintain (v): duy trì
major (adj): chính
method (n): phương pháp
period (n): giai đoạn
policy (n): chính sách
potential (adj): tiềm năng
previous (adj): trước đó
require (v): yêu cầu
research (n): nghiên cứu
